###########     
##   A    #
#o ###   o#
#  @ #    #
#     @   #
#         #    
###########     
            
