###############
#        A    #
#   @     o   #
#    o####    #
#      @      #
#  @ o        #
###############