###############
#              #
#A @     @     #
#  o   o####o  #
#      @       #
#  @ o         #
###############