#############
#       A   #
#   ###     #
#     # @  o#
#  @     o  # 
#        #  #
#############