#######    
#      ### 
#  A @ #   
#  o   ####
#     #    
#    #     
#######    
