#######  
#     ###
#    #   
#   ####
#  @   # 
#  A  #  
#######  
