############     
#          # 
#A @       #    
#  o    o  #
#  @       #     
#          #      
############