###########     
#A         # 
# @        #    
#      #   # 
# o  @ #   #     
#      #  o#      
###########     
            
