#######  
#     ###
#    #   
#  V ####
#      # 
#     #  
#######  
