  ################### 
 #    #           ###
 #   #  @     ####   
 #   ####     ##
 #             ###   
####   @          #####
########       ## ###
#              @   ###
###    ##   A      # 
##               ###
#        o o o    # 
 ###################