  ###################
 #    #           ###
 #   #  @     ####   
 #      ##  ######   
 #             #     
 #   @    @   ##     
# @          ##      
#     ###   @#       
#      #     ##      
#       #########    
#               #####
#                   #
 #                  #
#      A 