  ###################  
 #    #             ## 
 #    #   @   @  ####  
 # o   A #  ####       
 # o     #  #          
 #      ## ##          
  #########            
                       
