#######    
#  A   ### 
#    @ #   
#  o   ####
#     #    
#    #     
#######    
