#######     
#  A   ###  
#  @   #    
#  o   #### 
#     #     
#    #      
#######     
            
