  ################
 #    #          #
 #    #   @   @ ####
 # o   A #  ####
 # o     #  #
 #      ## ##
  #########