#######     
#      ###  
#A @   #    
#  o   #### 
#     #     
#    #      
#######     
            
