########     
#A      # 
# @  @  #    
#       # 
# o  o  #     
#       #      
########     
            
