########
#A     #
#   @  #
#      #
#  o   #
#      #
########