#######    
#      ### 
#    @ #   
#  A   ####
#     #    
#    #     
#######    
