#######     
# @#  #   
#A### #
## o  #
#     #     
#    #      
#######     
            
