###########
#         #
#    @    #
#  @      #
#  A      #
#       o #
###########